13 10
100 100
4 10  10  10  10  10  10  10  10  10  10  10 10
8 13  13  13  13  13  13  13  13  13  13  13  8  
8 13  13  13  13  13  13  13  13  13  13  13  8 
8 13  13  13  13  13  13  13  13  13  13  13  8
8 13  13  13  13  13  13  13  13  13  13  13  8 
8 13  13  13  13  13  13  13  13  13  13  13  8  
8 13  13  13  13  13  13  13  13  13  13  13  8 
8 13  13  13  13  13  13  13  13  13  13  13  8 
8 13  13  13  13  13  13  13  13  13  13  13  8  
8 10  10  10  10  10  10  10  10  10  10  10 10
