13 10
100 100
4 10 10 10 10 10 10 10 10 10 10 10 10
8 8  1  1  4  3  1  1  1  1  1  1  8  
8 8  4  1  1  1  1  2  2  1  1  1  8 
8 8  4  4  4  1  1  2  2  1  1  1  8
8 8  8  8  8  1  1  1  2  1  1  1  8 
8 1  1  1  1  1  1  1  2  1  1  1  8  
8 1  1  1  1  1  1  2  1  1  1  1  8 
8 1  1  1  1  1  1  1  3  1  1  1  8 
8 1  1  1  1  1  3  3  3  1  1  1  8  
8 10 10 10 10 10 10 10 10 10 10 10 10
