13 10
100 100
4 10 10 10 10 10 10 10 10 10 10 10 10
8 8  13  13  4  3  13  13  13  13  13  13  8  
8 8  4  13  13  13  13  13 13 13  13  13  8 
8 8  4  4  4  13  13  13 13 13  13  13  8
8 8  8  8  8  13  13  13  13 13  13  13  8 
8 13  13  13  13  13  13  13  13 13  13  13  8  
8 13  13  13  13  13  13  13  13  13  13  13  8 
8 13  13  13  13  13  13  13  3  13  13  13  8 
8 13  13  13  13  13  13  13  3  13  13  13  8  
8 10 10 10 10 10 10 10 10 10 10 10 10
